kuvat - offset

A tranpose seems broken

the whole matrix doesnt update at once, one pixel is behind

ABC kuvat

matrix_A = [
 1,   2,  3,  4,  -4,  3,  -2,  -1;
 5,   6,  7,  8,  -8,  7,  -6,  -5;
 9,  10, 11, 12, -12, 11, -10,  -9;
 13, 14, 15, 16, -16, 15, -14, -13;
 17, 18, 19, 20, -20, 19,  18, -17;
 21, 22, 23, 24, -24, 23,  22, -21;
 25, 26, 27, 28, -28, 27, -26, -25;
 29, 30, 31,  0,   0, 31, -30, -29 ]

matrix_B = [
 1,   2,  1,  2,   3,  4,  -4,  -3;
 5,   6,  5,  6,   7,  8,  -8,  -7;
 9,  10,  9, 10,  11, 12, -12, -11;
 13, 14, 13, 14,  15, 16, -16,  15;
 13, 14, 17, 18,  19, 20, -20,  19;
 21, 22, 21, 22,  23, 24, -24,  23;
 25, 26, 25, 26,  27, 28, -28, -27;
 29, 30, 29, 30,  31,  0,   0, -31 ]
 
matrix_C, = [
  22,   28,    6,   12,   18,   56,   -56,   88
 -50,  -36,  -82,  -68,  -54,  120,  -120,  312
-122, -100, -170, -148, -126,  184,  -184,  536
-194, -164, -258, -228, -198,  248,  -248,  760
 634,  708,  554,  628,  702, 1320, -1320,   12
 762,  852,  666,  756,  846, 1608, -1608,   20
-410, -356, -522, -468, -414,  440,  -440, 1432
-482, -420, -482, -420, -358,  632,  -632, 1784 ]

Task 2:
	1.
		ZYNQ7 Processing System: PCW_CLK0_FREQ=100 MHz
	2.
		matr_mem_interface writes the values to the brams.
	3.
		a
	4.
		a
	5.
		a